11111111111111111
11111111111111111
100O000O000000001
100C0000000CEP001
11111111111111111
11111111111111111