111111111111111111
10O000000000000011
100C0000000CEP0011
111111111111111111