111111111111111
1E00P01C0111110
100000000011111
100000000011111
100000000011101
111111111111111