111111111111111
1E00P01C0111111
100000000011111
100000000011111
100000000011E11
111111111111111