11111111111
1E00P01C011
11111111111