111111111111111
1000P01C0111111
100000000011111
100030000011111
1000000E0011111
111111111111111