1111111111111111111111111111
100000000C00C00000000C000001
1000000PE0000000000000000001
100000000C00C00000000C000001
100000000C00C00000000C000001
100000000C00C00000000C000001
100000000C00C00000000C000001
100000000C00C00000000C000001
100000000C00C00000000C000001
100000000C00C00000000C000001
100000000C00C00000000C000001
100000000C00C00000000C000001
100000000C00C00000000C000001
100000000C00C00000000C000001
100000000C00C00000000C000001
100000000C00C00000000C000001
100000000C00C00000000C000001
100000000C00C00000000C000001
100000000C00C00000000C000001
100000000C00C00000000C000001
100000000C00C00000000C000001
100000000C00C00000000C000001
100000000C00C00000000C000001
100000000C00C00000000C000001
100000000C00C00000000C000001
100000000C00C00000000C000001
100000000C00C00000000C000001
100000000C00C00000000C000001
100000000C00C00000000C000001
100000000C00C00000000C000001
100000000C00C00000000C000001
100000000C00C00000000C000001
100000000C00C00000000C000001
100000000C00C00000000C000001
100000000C00C00000000C000001
100000000C00C00000000C000001
100000000C00C00000000C000001
100000000C00C00000000C000001
1000000000000000000000000001
1111111111111111111111111111