1111111111111111111111111111111111
110000000000000C00000C000000E00001
1010010100100000101001000000010101
1010010010101010001001000C00011111
1P0000000C00C00000000C000000011011
1111111111111111111111111111111111