11111111111111111
10000000O00000001
100C0000000CEP001
11111111111111111