111111111111111
1000P01C0111111
100000000011111
100000000011111
1000000E00C1111
111111111111111