111111111111111111111111111111
10001000010C00C00000000C000001
1000000PCE00000011110000000001
1011111111100C001000000C000001
1000000001C010C000000011111001
111111111111111111111111111111