11111111111111111111111111111111111111111111111111111111111111111111111111111111111111111111
11000000C000000C00000C0000001000010000000000000000000000000000000000000000000000000000000011
10100101001000001010010000000101010001010100010100000001010000001010001010001010000010010101
100000000C00C00000000C000000C111110000000000100000100100000000100000010100000000000000000111
11111111111111000000000000000000000000000000000000000000000000000000000000000000000011111111
11111111111111111111111111111111111111000000000000000000011111111111111111111111111111111111
11000000C000000C00000C000000E000000000000000000000000000000000000000000000000000000000000011
10100101001000001010010000000101010001010100010100000001010000001010001010001010000010010101
1010010010101010001001000C000111110000010101000100000010101010100000010100010000000100000111
100000000C00C00000000C000000P111110000000000100000100100000000100000010100000000000000000111
11111111111111111111111111111111111111111111111111111111111111111111111111111111111111111111